###########################################################
#                                                         #
#   ╬                  ¶  ¶              ¶                #
#                                ¶                        #
#                                                         #
#    ¶  ¶               ¶                          ©©©©©©©#
#                                             ¶    ©""""""#
#           """"""""     ¶         °"""""       ¶  ©"""¥""#
#           """"""""             """""""""         ©""""""#
#©©©© ©©©©© """"""©©                               ©""""""#
#"""""""""© """"""°©                               ©""""""#
#"""""""""©                      ©©©©©©©©          ©""""""#
#"""""""""©               ¶      ©  / \ ©          ©""""""#
#"""""""""©            ¶¶¶       ©  |_| ©°         ©""""""#
#"""""""""©          ¶¶¶         ©      ©©©©       ©""""""#
#"""""""""©                      O                 ©""""""#
#"""""""""©O                                   """""""""""#
#"""""""""                                     """""""""""#
#"""""""""©                                    """""""""""#
###########################################################